S........#
#.###.##.#
#.#....#.#
#.#..#.#.#
#.##.#####
#.#......#
#.#.#..#.#
#####.####
#...#....G
#.#....#.#