S.##########################
#.#......#.................#
#.#.####...###############.#
#.#.#....#.#...............#
#.#.####.#.#.###############
#.#.#....#.#.#.............#
#.#.#.####.###.###########.#
#.#.#.#........#...........#
#...#...##################.#
#########....#.#.#.......#.#
#.#.......####.#.#######.#.#
#.#.###.###..#.#.#.......#.#
#...#.......##...#.#####.#.#
#####.#######..#.#.....#.#.#
#.....#.......##.##.####.#.#
#.#####.#######.....#......#
#.......#.......############
#######.#########........#.#
#.......#.........########.#
#.#######.######.##...#....G
#.........#.........#...##.#
############################