######...##....
S....#.#.###.#.
####.#.#...#.#G
.#...#.###.#.#.
.#.##.####...#.
...##....#####.
.#...#.#.......
.#####.###.####
.....#.##.##...
.#.###.......#.
##.####.######.
.#.##.#......#.
.#.##.#.#####..
.......#......#
#.##.###.##.###
#.........#...#